20, 20
12111111111111111111
10000000101001000011
11110111100011111001
10100000111000000101
10011010100011010001
11000010001010010101
10111000101001000101
10000010001100010101
10101110100010110001
10100000101010010101
10011110001001000001
11000001011100011111
10110100000011000001
10000101101000100101
10111111001110101001
10001000010000000111
10110001001111100001
11100010101000101001
10000000100000001001
13111111111111111111